111111111111111
111101000110001
110100010000101
010101111111111
000001000001101
111101010000101
100001010110101
101000010100111
101111110100001
101000011110111
111101010000001
100001111110111
101001000000101
111011011110000
111111111111111